b g b g b g b g
o o o o b b b b
g g g o b g g g
$
b b b b b b b b
o o o o o o o
g g g g g g
b g o g b
$
o o o o o o o o o
b b b b b b b
g g g g g g g g
b b b b b b b
$
b b b b b b b b
b b b b b b b b
b b b b b b b b
b b b b b b b b
$
g g b b g g b
o o g b g b g g
o o o o
g g g g b b b b
$
g g g g g g g g
g g g g g g g g
g g g g g g g g
g g g g g g g g
g g g g g g g g
$
g g g g g g g g g g
g g g g g g g g
b b b b b b b b b b
o o o o o o o o
o o o o o o o o o o